111111111
1C0C0B0C1
1C0C00001
10P00CCC1
100C0C001
100C0ECC1
111111111