11111111111111111
1000000000C000001
10P00000000000001
10001111100000001
10001E00000000001
11111111111111111